
R 1000    1000

NO ../textures/t1.png

WE ../textures/t3.png

F   201,255,0

EA ../textures/t3.png

SO  ../textures/t3.png

C 200,40,20

S ./textures/t4.png


1111111111111111111
1100000000000000001
1000110010001010111
1000000100101110111
1101111101101000111
1100020000000011111
11010000000000000E1
1111111111111111111