
R    1500  1500

NO ../textures/t1.png

WE ../textures/t3.png

F   201,255,0

EA ../textures/t3.png

SO  ../textures/t3.png

C 200,40,20

S ./textures/t4.png

11111111
10001001
100000W1
10000001
10000001
10000001
10100101
11111111